2222222222
0000110000
0330110330
0330110330
0000110000
2222222222