0000000000
0044444400
0042332400
0042332400
0044444400
0000000000