0000000000
0111111110
0155115510
0155115510
0111111110
0000000000