0101010101
2020202020
0303030303
4040404040
0505050505
0000000000