0000000000
1111011111
1000001000
1110000100
1000000010
1111011111