5500000055
0440000440
0033003300
0000220000
0002222000
1111111111