0000400000
0004440000
0012321000
0012221000
0011111000
0000000000