5555555555
5333333335
5344114435
5344114435
5333333335
5555555555