0000220000
0002442000
0024334200
0024334200
0002442000
0000220000