3333333333
2222222222
1111111111
0000000000
4444444444
5555555555