0000330000
0003333000
0555555550
0202002020
0202002020
0202002020