0000000000
1111111111
1414444141
1111111111
5555555555
5555555555