1100220011
1105225011
0233443320
0233443320
1105225011
1100220011