0000000000
2222222222
5510000155
5510000155
5551551555
5551551555