1111111111
5353535353
3434343434
1111001111
1111001111
1111001111