0440220440
0550220550
3300220033
0000220000
0000110000
1111111111