1111100000
2222220000
1111111000
2222222200
1111111110
3333333333