4455445544
3344334433
3322332233
2233223322
2211221122
1122112211