4411111144
0033113300
0000220000
0000220000
0033113300
4411111144