0000000000
0000110000
0011111100
0030330300
0404004040
5050000505