1234520011
2345120011
3451203300
4512303300
1100220011
1100220011